1111111111111111111111111111111
1000000000000000H000000000000E1
1001110011110111101111100000001
10010100000100001010C010C000001
1000010000C1000010000010000C001
1P0001001111011110000010C000001
1000010000C1000C1000C0100000001
100001000001000010000010C000001
100011101111011110000010000H001
1000000000000000000H00000000C01
1111111111111111111111111111111