1111111111111111111111
1P00000000000001000001
100000000000000100C001
1000000000000001000001
1000000000000001110001
1000001111100000000001
1000001HC0100000000001
1000000000000000000001
100C0000000000000000E1
1111111111111111111111