11111111111111
100000000001E1
10000C0C000001
1000000H000001
10H00000000001
10H00000000001
100001P1000001
10000111000H01
10111000111101
100C100000C001
11111111111111