11111111111111111111111111111111
1000000100000000000C100000100001
11111101011111111111101011101101
100C000100000000000010100C100101
101111H1011111111100101011110101
100000010000000001000010001H0101
10111101111101010100111111110101
10000000000001010000100000010101
11111101010001010100101010110101
100000010100C1C10100101010010101
10111101010111110100101010010101
10000001010000000100001010000101
10111101010111110100101010011101
1000000H0000000P0000101010010101
10111111011111011100101010010101
1010000000000000010010000H0001E1
11111111111111111111111111111111