1111111111111111111111111
1P101H0C10000C0111110C1E1
1000100110011001000100101
1010101110010001C00H01101
1010101100111101H00001001
101110110010C101C00H01001
1000001100101101111100001
100000000100000000C000001
1111111111111111111111111