1111111111111111111111111
1E0000000000000000000H001
1111111C00000000010H00001
100001000000000001000H001
100001000000000001HH00001
1000010000000000010H00HC1
100C010000000000010C00C01
1000010000000000010000001
10000000000000000100HCHH1
1P0C000000C00000010C000C1
1111111111111111111111111