11111111111111
100000000E0001
1000000C000001
10000000000001
100000000P0001
10000000000001
100C0000000001
10000000000001
10000000000001
100C000000C001
11111111111111

10101111110001110100111110111101
10100000000000000100000000000001
10101011101110110111011110111111
1010101C000010000000000000000001
10101010111011111011111100010101
10001010111010000010000000010101
11101010000010111110101100010101
10001011111010000010100000010101
10100000000010000000101100010101
10111111101110111111101111111101
1000000000000000000000000E000001
11111111111111111111111111111111