11111111111111
100000000001E1
1000000C000001
10000000000001
10000000000001
10000000000001
100001P1000001
10000111000001
10111000111101
100C100000C001
11111111111111