1111111
10000P1
1000001
1000C01
1000001
1E00001
1111111